16
1
430 345 0 360 5000 1 60 
1
430 345 0 360 5000 1 140 
1
430 345 0 360 5000 1 220 
1
430 345 0 360 5000 1 300
1
430 345 -180 180 5000 1 60 
1
430 345 -180 180 5000 1 140 
1
430 345 -180 180 5000 1 220 
1
430 345 -180 180 5000 1 300
1
430 345 -90 270 5000 1 60 
1
430 345 -90 270 5000 1 140 
1
430 345 -90 270 5000 1 220 
1
430 345 -90 270 5000 1 300
1
430 345 -270 90 5000 1 60 
1
430 345 -270 90 5000 1 140 
1
430 345 -270 90 5000 1 220 
1
430 345 -270 90 5000 1 300