0 0 0 0 0 0 0 0 0 0 0 0 0 0 0 0 0 0 0 0 0 0
0 0 0 0 0 0 0 0 0 0 0 0 0 0 0 0 0 0 0 0 0 0
0 0 2 2 1 1 1 1 1 1 1 1 1 1 1 1 1 1 4 0 0 0
0 0 0 0 0 0 0 0 0 0 0 0 0 0 0 0 0 1 0 0 0 0
0 0 5 1 1 1 1 1 1 1 1 1 1 1 1 1 0 1 0 0 0 0
0 0 0 0 1 0 0 0 0 0 0 0 0 0 0 1 0 1 0 0 0 0
0 0 0 0 1 0 1 1 1 1 1 1 1 3 0 1 0 1 0 0 0 0
0 0 0 0 1 0 1 0 1 1 1 1 1 3 0 1 0 1 0 0 0 0
0 0 0 0 1 0 1 0 0 0 0 0 0 0 0 1 0 1 0 0 0 0
0 0 0 0 1 0 1 1 1 1 1 1 1 1 1 1 0 1 0 0 0 0
0 0 0 0 1 0 0 0 0 0 0 0 0 0 0 0 0 1 0 0 0 0
0 0 0 0 1 1 1 1 1 1 1 1 1 1 1 1 1 1 0 0 0 0
0 0 0 0 0 0 0 0 0 0 0 0 0 0 0 0 0 0 0 0 0 0
0 0 0 0 0 0 0 0 0 0 0 0 0 0 0 0 0 0 0 0 0 0
105 160
90 90
725 160
85 240




